20 12
8 1 1 1 22 22 22 22 43 43 43 43 57 56 57 56 1 33 34 1
1 1 1 1 18 23 18 23 26 26 26 26 66 67 56 57 1 39 35 1
5 5 5 1 20 23 18 23 26 26 31 31 49 49 57 56 1 1 1 1
5 5 5 1 23 23 20 23 24 24 27 27 49 49 66 67 1 1 1 44
1 9 1 1 23 23 23 23 32 32 36 41 55 55 49 49 33 34 1 1
7 4 1 1 23 23 23 23 37 32 32 41 56 57 55 55 39 35 1 1
1 4 1 3 23 23 23 23 28 29 29 28 57 56 50 52 1 1 1 1
14 0 0 0 23 16 22 22 42 28 38 38 56 50 53 61 1 1 1 44
2 2 2 2 16 22 21 21 42 30 38 38 50 53 53 53 1 44 1 1
2 2 2 2 22 21 21 21 42 38 38 38 47 53 53 53 1 1 1 1
13 13 13 13 21 21 21 21 42 25 38 25 47 53 53 53 33 40 40 34
13 13 13 13 21 21 21 21 28 28 28 28 48 60 53 53 39 40 40 35